

NO ./textures/wall_1.xpm


SO ./textures/wall_2.xpm

WE ./textures/wall_3.xpm

EA ./textures/wall_4.xpm

F 160,82,45


C 135,206,235

   111111111111111111
   100000000000000001
   100000000000000001
   100000000000000001
   100000000000000001
   1000N0000000000001
   100000000000000001
   100000000000000001
   111111111111111111
