NO ./textures/flower.xpm
SO ./textures/motif-jungle.xpm
WE ./textures/motif-blanc.xpm
EA ./textures/motif-noir-dore.xpm

F 241,228,200
C 233,233,222

        11111111111111111111111111111
        10000000001100000000000000001
        10110000011100000000000000001
        10010000000000000000000000001
1111111110110000011100000000000000001
1000000000110000011101111101111111111
1111011111111101110000001000000000001
1111011111111101110000001000000000001
1100000011010101110000001000000000001
1000000000000000010000000000000000001
1000000000000111110111111000000000001
1100000111010100000000001000000000001
11110111 1110000000N00000000000000001
11110111 1110100000000001000000000001
11111111 1111111111111111111111111111
