NO ./textures/wood.xpm
C 55,200,160
F 122,122,122
SO ./textures/stone.xpm
EA ./textures/brick.xpm
WE ./textures/cave.xpm



11111111111111111
10000000000000001
10000000000000001
10000000000000001
10000000000000001
10000000000000001
10000000000000001
10000000000000001
10000000000000001
10000000000000001
10000000000000001
10000000S00000001
11111111111111111