
NO ./textures/bleu-marine.xpm
SO ./textures/door.xpm
EA ./textures/brick.xpm
WE ./textures/cave.xpm

C 255,200.122
F 122,122,122

11111111111111111
10000000000000001
10000000000000001        N
10000000000000001
10000000000000001
10000000000000001
10000000000000001
10000000000000001
10000000000000001
10000000000000001
10000000000000001
10000000000000001
11111111111111111
